#######
#FFFFF#
#FEEEF#
#FFEEF#
#FFEEF#
#FFFFF#
#######