#######
#FFFFF#
#FFFFF#
#WFFFW#
#WGFFW#
#WWWWW#
#######